NO ./textures/plank.png

SO ./textures/plank.png



EA ./textures/plank_2.png
WE ./textures/plank_2.png

F ./textures/cobblestone.png



C ./textures/sky.png

111111
10000111111111111111111111111111111111111
100E000D0000000000000000D0000000000000001
10001001001001111111111111111001111111111
10001001001001000000000001000001
1111111111100111100100111111100111111
      1001000000001000001001001000001
      1001111001001001001001001001001
      1000000001001001001000001001001
      1001001111111111001111001111001
      1001000000001000001000001001001
      1111111001001111001111111001001
      1000000001000001000000000001001
      1111001111001001111001111001001
      1000001000001001001000001001001
      1001111001111111001001111111001
      10010010010010010010000010000011111111111
      10010010010010010011110011110000000000001
      10000010000000010000010000000011111111111
      1001001001111001001001111111001
      100100100100000000100000000000111111111
      100111100111111111111111111100000000D01
      1001  1001                 111111111111
      1001  1001
      1001111001
      1000000001
      1001111001
      1111  1111
